0 0 0 0 0 0 0 0 0 0 0 0 0 0 0 0
0 6 2 0 2 2 2 2 2 2 2 2 2 2 5 0
0 2 2 0 10 0 0 0 0 0 2 0 2 2 2 0
0 2 0 0 2 0 2 2 5 0 2 0 2 2 2 0
0 2 0 0 2 2 2 2 2 0 2 0 0 0 2 0
0 2 2 2 2 0 0 0 0 0 2 2 2 2 2 0
0 0 0 2 0 0 2 2 2 0 0 0 0 0 2 0
0 0 0 2 0 2 2 0 2 2 2 0 2 2 2 0
0 0 0 2 0 2 0 0 0 0 2 0 0 0 0 0
0 2 2 2 0 2 2 2 2 0 2 10 2 2 5 0
0 2 0 0 0 0 0 0 2 0 0 2 0 2 2 0
0 2 0 2 2 2 5 0 2 0 0 2 0 0 0 0
0 2 0 2 2 2 2 0 2 0 2 2 2 2 2 0
0 2 0 2 0 0 0 0 2 0 2 2 2 3 2 0
0 2 2 2 2 2 10 2 2 0 5 2 2 2 2 0
0 0 0 0 0 0 0 0 0 0 0 0 0 0 0 0