0 0 0 0 0 0 0 0 0 0 0 0 0 0 0 0
0 2 6 2 2 2 2 2 2 2 2 2 2 2 2 0
0 0 0 0 0 0 0 0 0 0 0 0 0 0 2 0
0 2 2 2 2 2 2 2 2 2 2 2 2 0 2 0
0 2 0 0 0 0 0 0 0 0 0 0 2 0 2 0
0 2 0 2 2 2 2 2 2 2 2 0 2 0 2 0
0 2 0 2 0 0 0 0 0 0 2 0 2 0 2 0
0 2 0 2 0 10 10 5 5 0 2 0 2 0 2 0
0 2 0 2 0 10 0 5 3 0 2 0 2 0 2 0
0 2 0 2 0 10 0 0 0 0 2 0 2 0 2 0
0 2 0 2 0 10 2 2 2 2 2 0 2 0 2 0
0 2 0 2 0 0 0 0 0 0 0 0 2 0 2 0
0 2 0 2 2 2 2 2 2 2 2 2 2 0 2 0
0 2 0 0 0 0 0 0 0 0 0 0 0 0 2 0
0 2 2 2 2 2 2 2 2 2 2 2 2 2 2 0
0 0 0 0 0 0 0 0 0 0 0 0 0 0 0 0